{
  "003900000000000000390c000000000000000000000000000001": "0073000000000000003907000000000000000000000000000001",
  "004000000000000000390c000000000000000000000000000001": "007400000000000000390b000000000000000000000000000001",
  "003900000000000000390c000000000000000100000000000002": "0073000000000000003908000000000000000000000000000002",
  "004000000000000000390c000000000000000100000000000002": "007400000000000000390b000000000000000000000000000002",
  "003900000000000000390c000000000000000200000000000003": "0074000000000000003906000000000000000000000000000003",
  "004000000000000000390c000000000000000200000000000003": "007500000000000000390b000000000000000000000000000003",
  "003900000000000000390c000000000000000300000000000004": "0073000000000000003907000000000000000000000000000004",
  "004000000000000000390c000000000000000300000000000004": "007400000000000000390b000000000000000000000000000004",
  "003a00000000000000390c000000000000000400000000000005": "0073000000000000003907000000000000000000000000000005",
  "004000000000000000390c000000000000000400000000000005": "007400000000000000390b000000000000000000000000000005",
  "003a00000000000000390c000000000000000500000000000006": "0073000000000000003906000000000000000000000000000006",
  "004000000000000000390c000000000000000500000000000006": "007400000000000000390b000000000000000000000000000006",
  "003900000000000000390c000000000000000600000000000007": "0075000000000000003907000000000000000000000000000007",
  "004000000000000000390c000000000000000600000000000007": "007600000000000000390b000000000000000000000000000007",
  "003a00000000000000390c000000000000000700000000000008": "0074000000000000003907000000000000000000000000000008",
  "004000000000000000390c000000000000000700000000000008": "007500000000000000390b000000000000000000000000000008",
  "003900000000000000390c000000000000000800000000000009": "0073000000000000003907000000000000000000000000000009",
  "004000000000000000390c000000000000000800000000000009": "007400000000000000390b000000000000000000000000000009",
  "003a000000000000000a0c00000000000000090000000000000a": "0073000000000000000a0800000000000000000000000000000a",
  "004000000000000000390c00000000000000090000000000000a": "007400000000000000390b00000000000000000000000000000a",
  "003900000000000000390c000000000000000a0000000000000b": "007300000000000000390700000000000000000000000000000b",
  "004000000000000000390c000000000000000a0000000000000b": "007400000000000000390b00000000000000000000000000000b",
  "003a00000000000000390c000000000000000b0000000000000c": "007200000000000000390700000000000000000000000000000c",
  "004000000000000000390c000000000000000b0000000000000c": "007300000000000000390b00000000000000000000000000000c",
  "003a00000000000000390c000000000000000c0000000000000d": "007300000000000000390800000000000000000000000000000d",
  "004100000000000000390c000000000000000c0000000000000d": "007400000000000000390b00000000000000000000000000000d",
  "003900000000000000390c000000000000000d0000000000000e": "007400000000000000390600000000000000000000000000000e",
  "004000000000000000390c000000000000000d0000000000000e": "007500000000000000390b00000000000000000000000000000e",
  "003900000000000000390c000000000000000e0000000000000f": "007300000000000000390600000000000000000000000000000f",
  "004000000000000000390c000000000000000e0000000000000f": "007400000000000000390b00000000000000000000000000000f",
  "003a00000000000000390c000000000000000f00000000000010": "0072000000000000003908000000000000000000000000000010",
  "004000000000000000390c000000000000000f00000000000010": "007300000000000000390b000000000000000000000000000010",
  "003900000000000000390c000000000000001000000000000011": "0073000000000000003906000000000000000000000000000011",
  "004000000000000000390c000000000000001000000000000011": "007400000000000000390b000000000000000000000000000011",
  "003900000000000000390c000000000000001100000000000012": "0073000000000000003907000000000000000000000000000012",
  "003f00000000000000390c000000000000001100000000000012": "007400000000000000390b000000000000000000000000000012",
  "003900000000000000390c000000000000001200000000000013": "0073000000000000003904000000000000000000000000000013",
  "004000000000000000390c000000000000001200000000000013": "007400000000000000390b000000000000000000000000000013",
  "003900000000000000390c000000000000001300000000000014": "0071000000000000003908000000000000000000000000000014",
  "004000000000000000390c000000000000001300000000000014": "007200000000000000390b000000000000000000000000000014",
  "003900000000000000390c000000000000001400000000000015": "0072000000000000003907000000000000000000000000000015",
  "004000000000000000390c000000000000001400000000000015": "007300000000000000390b000000000000000000000000000015",
  "003900000000000000390c000000000000001500000000000016": "0072000000000000003907000000000000000000000000000016",
  "004000000000000000390c000000000000001500000000000016": "007300000000000000390b000000000000000000000000000016",
  "003a00000000000000390c000000000000001600000000000017": "0074000000000000003907000000000000000000000000000017",
  "004000000000000000390c000000000000001600000000000017": "007500000000000000390b000000000000000000000000000017",
  "003900000000000000390c000000000000001700000000000018": "0073000000000000003905000000000000000000000000000018",
  "004000000000000000390c000000000000001700000000000018": "007400000000000000390b000000000000000000000000000018",
  "003a00000000000000390c000000000000001800000000000019": "0073000000000000003907000000000000000000000000000019",
  "004000000000000000390c000000000000001800000000000019": "007400000000000000390b000000000000000000000000000019",
  "003900000000000000390c00000000000000190000000000001a": "007200000000000000390600000000000000000000000000001a",
  "004000000000000000390c00000000000000190000000000001a": "007300000000000000390b00000000000000000000000000001a",
  "003a00000000000000390c000000000000001a0000000000001b": "007300000000000000390600000000000000000000000000001b",
  "004000000000000000390c000000000000001a0000000000001b": "007400000000000000390b00000000000000000000000000001b",
  "003900000000000000390c000000000000001b0000000000001c": "007300000000000000390700000000000000000000000000001c",
  "004000000000000000390c000000000000001b0000000000001c": "007400000000000000390b00000000000000000000000000001c",
  "003a00000000000000390c000000000000001c0000000000001d": "007400000000000000390700000000000000000000000000001d",
  "004000000000000000390c000000000000001c0000000000001d": "007500000000000000390b00000000000000000000000000001d",
  "003a00000000000000390c000000000000001d0000000000001e": "007300000000000000390800000000000000000000000000001e",
  "004000000000000000390c000000000000001d0000000000001e": "007400000000000000390b00000000000000000000000000001e",
  "003a00000000000000390c000000000000001e0000000000001f": "007300000000000000390700000000000000000000000000001f",
  "004100000000000000390c000000000000001e0000000000001f": "007400000000000000390b00000000000000000000000000001f",
  "003a00000000000000390c000000000000001f00000000000020": "0073000000000000003908000000000000000000000000000020",
  "004000000000000000390c000000000000001f00000000000020": "007400000000000000390b000000000000000000000000000020",
  "003900000000000000390c000000000000002000000000000021": "0073000000000000003907000000000000000000000000000021",
  "004000000000000000390c000000000000002000000000000021": "007400000000000000390b000000000000000000000000000021",
  "003900000000000000390c000000000000002100000000000022": "0073000000000000003907000000000000000000000000000022",
  "004000000000000000390c000000000000002100000000000022": "007400000000000000390b000000000000000000000000000022",
  "003900000000000000390c000000000000002200000000000023": "0073000000000000003907000000000000000000000000000023",
  "004000000000000000390c000000000000002200000000000023": "007400000000000000390b000000000000000000000000000023",
  "003a00000000000000390c000000000000002300000000000024": "006f000000000000003907000000000000000000000000000024",
  "004000000000000000390c000000000000002300000000000024": "007000000000000000390b000000000000000000000000000024",
  "003900000000000000390c000000000000002400000000000025": "0070000000000000003907000000000000000000000000000025",
  "004000000000000000390c000000000000002400000000000025": "007100000000000000390b000000000000000000000000000025",
  "003900000000000000390c000000000000002500000000000026": "0070000000000000003907000000000000000000000000000026",
  "004000000000000000390c000000000000002500000000000026": "007100000000000000390b000000000000000000000000000026",
  "003900000000000000390c000000000000002600000000000027": "006f000000000000003907000000000000000000000000000027",
  "004000000000000000390c000000000000002600000000000027": "007000000000000000390b000000000000000000000000000027",
  "003900000000000000390c000000000000002700000000000028": "006f000000000000003907000000000000000000000000000028",
  "004000000000000000390c000000000000002700000000000028": "007000000000000000390b000000000000000000000000000028",
  "003a00000000000000390c000000000000002800000000000029": "006f000000000000003907000000000000000000000000000029",
  "004000000000000000390c000000000000002800000000000029": "007000000000000000390b000000000000000000000000000029",
  "003900000000000000390c00000000000000290000000000002a": "006f00000000000000390600000000000000000000000000002a",
  "004000000000000000390c00000000000000290000000000002a": "007000000000000000390b00000000000000000000000000002a",
  "003a00000000000000390c000000000000002a0000000000002b": "006d00000000000000390700000000000000000000000000002b",
  "004100000000000000390c000000000000002a0000000000002b": "006e00000000000000390b00000000000000000000000000002b",
  "003900000000000000390c000000000000002b0000000000002c": "006d00000000000000390700000000000000000000000000002c",
  "004100000000000000390c000000000000002b0000000000002c": "006e00000000000000390b00000000000000000000000000002c",
  "003900000000000000390c000000000000002c0000000000002d": "006d00000000000000390600000000000000000000000000002d",
  "004000000000000000390c000000000000002c0000000000002d": "006e00000000000000390b00000000000000000000000000002d",
  "003900000000000000390c000000000000002d0000000000002e": "006e00000000000000390700000000000000000000000000002e",
  "004000000000000000390c000000000000002d0000000000002e": "006f00000000000000390b00000000000000000000000000002e",
  "003a00000000000000390c000000000000002e0000000000002f": "006d00000000000000390700000000000000000000000000002f",
  "004000000000000000390c000000000000002e0000000000002f": "006e00000000000000390b00000000000000000000000000002f",
  "003900000000000000390c000000000000002f00000000000030": "006d000000000000003906000000000000000000000000000030",
  "004000000000000000390c000000000000002f00000000000030": "006e00000000000000390b000000000000000000000000000030",
  "003a00000000000000390c000000000000003000000000000031": "006d000000000000003906000000000000000000000000000031",
  "004100000000000000390c000000000000003000000000000031": "006e00000000000000390b000000000000000000000000000031",
  "003900000000000000390c000000000000003100000000000032": "006c000000000000003905000000000000000000000000000032",
  "004000000000000000390c000000000000003100000000000032": "006d00000000000000390b000000000000000000000000000032",
  "003900000000000000390c000000000000003200000000000033": "006d000000000000003907000000000000000000000000000033",
  "004000000000000000390c000000000000003200000000000033": "006e00000000000000390b000000000000000000000000000033",
  "003a00000000000000390c000000000000003300000000000034": "006c000000000000003908000000000000000000000000000034",
  "004000000000000000390c000000000000003300000000000034": "006d00000000000000390b000000000000000000000000000034",
  "003a00000000000000390c000000000000003400000000000035": "006c00000000000000390b000000000000000000000000000035",
  "004000000000000000390c000000000000003400000000000035": "006d000000000000003909000000000000000000000000000035",
  "003900000000000000390c000000000000003500000000000036": "006b000000000000003907000000000000000000000000000036",
  "004000000000000000390c000000000000003500000000000036": "006c00000000000000390b000000000000000000000000000036",
  "003900000000000000390c000000000000003600000000000037": "006a000000000000003908000000000000000000000000000037",
  "003f00000000000000390c000000000000003600000000000037": "006b00000000000000390b000000000000000000000000000037",
  "003900000000000000390c000000000000003700000000000038": "006b000000000000003904000000000000000000000000000038",
  "004000000000000000390c000000000000003700000000000038": "006c00000000000000390b000000000000000000000000000038",
  "003900000000000000390c000000000000003800000000000039": "006b000000000000003906000000000000000000000000000039",
  "004000000000000000390c000000000000003800000000000039": "006c00000000000000390b000000000000000000000000000039",
  "003900000000000000390c00000000000000390000000000003a": "006900000000000000390700000000000000000000000000003a",
  "004000000000000000390c00000000000000390000000000003a": "006a00000000000000390b00000000000000000000000000003a",
  "003a00000000000000390c000000000000003a0000000000003b": "006a00000000000000390700000000000000000000000000003b",
  "004000000000000000390c000000000000003a0000000000003b": "006b00000000000000390b00000000000000000000000000003b",
  "003a00000000000000390c000000000000003b0000000000003c": "006a00000000000000390800000000000000000000000000003c",
  "004100000000000000390c000000000000003b0000000000003c": "006b00000000000000390b00000000000000000000000000003c",
  "003900000000000000390c000000000000003c0000000000003d": "006900000000000000390700000000000000000000000000003d",
  "004000000000000000390c000000000000003c0000000000003d": "006a00000000000000390b00000000000000000000000000003d",
  "003a00000000000000390c000000000000003d0000000000003e": "006a00000000000000390800000000000000000000000000003e",
  "004000000000000000390c000000000000003d0000000000003e": "006b00000000000000390b00000000000000000000000000003e",
  "003900000000000000390c000000000000003e0000000000003f": "006a00000000000000390600000000000000000000000000003f",
  "004000000000000000390c000000000000003e0000000000003f": "006b00000000000000390b00000000000000000000000000003f",
  "003900000000000000390c000000000000003f00000000000040": "006a000000000000003906000000000000000000000000000040",
  "004000000000000000390c000000000000003f00000000000040": "006b00000000000000390b000000000000000000000000000040",
  "003900000000000000390c000000000000004000000000000041": "0069000000000000003907000000000000000000000000000041",
  "004000000000000000390c000000000000004000000000000041": "006a00000000000000390b000000000000000000000000000041",
  "003a00000000000000390c000000000000004100000000000042": "0069000000000000003907000000000000000000000000000042",
  "004100000000000000390c000000000000004100000000000042": "006a00000000000000390b000000000000000000000000000042",
  "003900000000000000390c000000000000004200000000000043": "0069000000000000003907000000000000000000000000000043",
  "004000000000000000390c000000000000004200000000000043": "006a00000000000000390b000000000000000000000000000043",
  "003900000000000000390c000000000000004300000000000044": "0069000000000000003906000000000000000000000000000044",
  "004100000000000000390c000000000000004300000000000044": "006a00000000000000390b000000000000000000000000000044",
  "003900000000000000390c000000000000004400000000000045": "0069000000000000003906000000000000000000000000000045",
  "004000000000000000390c000000000000004400000000000045": "006a00000000000000390b000000000000000000000000000045",
  "003900000000000000390c000000000000004500000000000046": "0068000000000000003907000000000000000000000000000046",
  "004000000000000000390c000000000000004500000000000046": "006900000000000000390b000000000000000000000000000046",
  "003900000000000000390c000000000000004600000000000047": "0069000000000000003906000000000000000000000000000047",
  "004000000000000000390c000000000000004600000000000047": "006a00000000000000390b000000000000000000000000000047",
  "003900000000000000390c000000000000004700000000000048": "0068000000000000003906000000000000000000000000000048",
  "004000000000000000390c000000000000004700000000000048": "006900000000000000390b000000000000000000000000000048",
  "003a00000000000000390c000000000000004800000000000049": "0068000000000000003907000000000000000000000000000049",
  "004000000000000000390c000000000000004800000000000049": "006900000000000000390b000000000000000000000000000049",
  "003900000000000000390c00000000000000490000000000004a": "006800000000000000390800000000000000000000000000004a",
  "004000000000000000390c00000000000000490000000000004a": "006900000000000000390b00000000000000000000000000004a",
  "003900000000000000390c000000000000004a0000000000004b": "006800000000000000390700000000000000000000000000004b",
  "004000000000000000390c000000000000004a0000000000004b": "006900000000000000390b00000000000000000000000000004b",
  "003900000000000000390c000000000000004b0000000000004c": "006800000000000000390800000000000000000000000000004c",
  "004000000000000000390c000000000000004b0000000000004c": "006900000000000000390b00000000000000000000000000004c",
  "003900000000000000390c000000000000004c0000000000004d": "006700000000000000390500000000000000000000000000004d",
  "004000000000000000390c000000000000004c0000000000004d": "006800000000000000390b00000000000000000000000000004d",
  "003a00000000000000390c000000000000004d0000000000004e": "006600000000000000390700000000000000000000000000004e",
  "004000000000000000390c000000000000004d0000000000004e": "006700000000000000390b00000000000000000000000000004e",
  "003a00000000000000390c000000000000004e0000000000004f": "006600000000000000390700000000000000000000000000004f",
  "004000000000000000390c000000000000004e0000000000004f": "006700000000000000390b00000000000000000000000000004f",
  "003a00000000000000390c000000000000004f00000000000050": "0066000000000000003907000000000000000000000000000050",
  "004000000000000000390c000000000000004f00000000000050": "006700000000000000390b000000000000000000000000000050",
  "003900000000000000390c000000000000005000000000000051": "0066000000000000003906000000000000000000000000000051",
  "004000000000000000390c000000000000005000000000000051": "006700000000000000390b000000000000000000000000000051",
  "003a000000000000000a0c000000000000005100000000000052": "0066000000000000000a08000000000000000000000000000052",
  "004000000000000000390c000000000000005100000000000052": "006700000000000000390b000000000000000000000000000052",
  "003a00000000000000390c000000000000005200000000000053": "0065000000000000003907000000000000000000000000000053",
  "004000000000000000390c000000000000005200000000000053": "006600000000000000390b000000000000000000000000000053",
  "003a00000000000000390c000000000000005300000000000054": "006500000000000000390b000000000000000000000000000054",
  "003f00000000000000390c000000000000005300000000000054": "0066000000000000003909000000000000000000000000000054",
  "003900000000000000390c000000000000005400000000000055": "0064000000000000003905000000000000000000000000000055",
  "004100000000000000390c000000000000005400000000000055": "006500000000000000390b000000000000000000000000000055",
  "003b00000000000000390c000000000000005500000000000056": "006500000000000000390b000000000000000000000000000056",
  "004000000000000000390c000000000000005500000000000056": "0066000000000000003909000000000000000000000000000056",
  "003900000000000000390c000000000000005600000000000057": "0064000000000000003903000000000000000000000000000057",
  "004100000000000000390c000000000000005600000000000057": "006500000000000000390b000000000000000000000000000057",
  "003900000000000000390c000000000000005700000000000058": "0064000000000000003906000000000000000000000000000058",
  "004000000000000000390c000000000000005700000000000058": "006500000000000000390b000000000000000000000000000058",
  "003900000000000000390c000000000000005800000000000059": "0064000000000000003906000000000000000000000000000059",
  "004100000000000000390c000000000000005800000000000059": "006500000000000000390b000000000000000000000000000059",
  "003900000000000000390c00000000000000590000000000005a": "006300000000000000390400000000000000000000000000005a",
  "004000000000000000390c00000000000000590000000000005a": "006400000000000000390b00000000000000000000000000005a",
  "003900000000000000390c000000000000005a0000000000005b": "006400000000000000390300000000000000000000000000005b",
  "004000000000000000390c000000000000005a0000000000005b": "006500000000000000390b00000000000000000000000000005b",
  "003900000000000000390c000000000000005b0000000000005c": "006400000000000000390400000000000000000000000000005c",
  "003f00000000000000390c000000000000005b0000000000005c": "006500000000000000390b00000000000000000000000000005c",
  "003900000000000000390c000000000000005c0000000000005d": "006300000000000000390400000000000000000000000000005d",
  "004000000000000000390c000000000000005c0000000000005d": "006400000000000000390b00000000000000000000000000005d",
  "003900000000000000390c000000000000005d0000000000005e": "006300000000000000390400000000000000000000000000005e",
  "003f00000000000000390c000000000000005d0000000000005e": "006400000000000000390b00000000000000000000000000005e",
  "003900000000000000390c000000000000005e0000000000005f": "006300000000000000390300000000000000000000000000005f",
  "004100000000000000390c000000000000005e0000000000005f": "006400000000000000390b00000000000000000000000000005f",
  "003a00000000000000390c000000000000005f00000000000060": "006300000000000000390b000000000000000000000000000060",
  "003f00000000000000390c000000000000005f00000000000060": "0064000000000000003909000000000000000000000000000060",
  "003a00000000000000390c000000000000006000000000000061": "006300000000000000390b000000000000000000000000000061",
  "003f00000000000000390c000000000000006000000000000061": "0064000000000000003909000000000000000000000000000061",
  "003900000000000000390c000000000000006100000000000062": "0062000000000000003903000000000000000000000000000062",
  "004000000000000000390c000000000000006100000000000062": "006300000000000000390b000000000000000000000000000062",
  "003a00000000000000390c000000000000006200000000000063": "006300000000000000390b000000000000000000000000000063",
  "003f00000000000000390c000000000000006200000000000063": "0064000000000000003908000000000000000000000000000063",
  "003900000000000000390c000000000000006300000000000064": "0062000000000000003903000000000000000000000000000064",
  "004000000000000000390c000000000000006300000000000064": "006300000000000000390b000000000000000000000000000064",
  "003a00000000000000390c000000000000006400000000000065": "006300000000000000390b000000000000000000000000000065",
  "004000000000000000390c000000000000006400000000000065": "006400000000000000390a000000000000000000000000000065",
  "003900000000000000390c000000000000006500000000000066": "0061000000000000003903000000000000000000000000000066",
  "004000000000000000390c000000000000006500000000000066": "006200000000000000390b000000000000000000000000000066",
  "003900000000000000390c000000000000006600000000000067": "0061000000000000003903000000000000000000000000000067",
  "004000000000000000390c000000000000006600000000000067": "006200000000000000390b000000000000000000000000000067",
  "003900000000000000390c000000000000006700000000000068": "0060000000000000003905000000000000000000000000000068",
  "004000000000000000390c000000000000006700000000000068": "006100000000000000390b000000000000000000000000000068",
  "003900000000000000390c000000000000006800000000000069": "0060000000000000003904000000000000000000000000000069",
  "004000000000000000390c000000000000006800000000000069": "006100000000000000390b000000000000000000000000000069",
  "003900000000000000390c00000000000000690000000000006a": "006000000000000000390500000000000000000000000000006a",
  "004000000000000000390c00000000000000690000000000006a": "006100000000000000390b00000000000000000000000000006a",
  "003900000000000000390c000000000000006a0000000000006b": "006100000000000000390300000000000000000000000000006b",
  "004000000000000000390c000000000000006a0000000000006b": "006200000000000000390b00000000000000000000000000006b",
  "003900000000000000390c000000000000006b0000000000006c": "006000000000000000390500000000000000000000000000006c",
  "004000000000000000390c000000000000006b0000000000006c": "006100000000000000390b00000000000000000000000000006c",
  "003900000000000000390c000000000000006c0000000000006d": "006000000000000000390500000000000000000000000000006d",
  "004000000000000000390c000000000000006c0000000000006d": "006100000000000000390b00000000000000000000000000006d",
  "003900000000000000390c000000000000006d0000000000006e": "005f00000000000000390400000000000000000000000000006e",
  "004000000000000000390c000000000000006d0000000000006e": "006000000000000000390b00000000000000000000000000006e",
  "0039000000000000000a0c000000000000006e0000000000006f": "005f000000000000000a0600000000000000000000000000006f",
  "003f00000000000000390c000000000000006e0000000000006f": "006000000000000000390b00000000000000000000000000006f",
  "003900000000000000390c000000000000006f00000000000070": "005d000000000000003905000000000000000000000000000070",
  "004000000000000000390c000000000000006f00000000000070": "005e00000000000000390b000000000000000000000000000070",
  "003900000000000000390c000000000000007000000000000071": "005f000000000000003904000000000000000000000000000071",
  "004000000000000000390c000000000000007000000000000071": "006000000000000000390b000000000000000000000000000071",
  "003900000000000000390c000000000000007100000000000072": "005d000000000000003905000000000000000000000000000072",
  "004000000000000000390c000000000000007100000000000072": "005e00000000000000390b000000000000000000000000000072",
  "000000000000000000070c000000000000007200000000000073": "005e000000000000000700000000000000000000000000000073",
  "003c00000000000000390c000000000000007200000000000073": "005f00000000000000390b000000000000000000000000000073",
  "003a00000000000000390c000000000000007300000000000074": "005e00000000000000390b000000000000000000000000000074",
  "004000000000000000390c000000000000007300000000000074": "005f00000000000000390a000000000000000000000000000074",
  "003900000000000000390c000000000000007400000000000075": "005f000000000000003909000000000000000000000000000075",
  "004000000000000000390c000000000000007400000000000075": "006000000000000000390b000000000000000000000000000075",
  "003900000000000000390c000000000000007500000000000076": "005d000000000000003906000000000000000000000000000076",
  "004000000000000000390c000000000000007500000000000076": "005e00000000000000390b000000000000000000000000000076",
  "003a00000000000000390c000000000000007600000000000077": "005f000000000000003909000000000000000000000000000077",
  "004000000000000000390c000000000000007600000000000077": "006000000000000000390b000000000000000000000000000077",
  "003a00000000000000390c000000000000007700000000000078": "005e00000000000000390b000000000000000000000000000078",
  "004000000000000000390c000000000000007700000000000078": "005f00000000000000390a000000000000000000000000000078",
  "003a00000000000000390c000000000000007800000000000079": "005f000000000000003909000000000000000000000000000079",
  "004100000000000000390c000000000000007800000000000079": "006000000000000000390b000000000000000000000000000079",
  "003a00000000000000390c00000000000000790000000000007a": "005e00000000000000390b00000000000000000000000000007a",
  "004000000000000000390c00000000000000790000000000007a": "005f00000000000000390a00000000000000000000000000007a",
  "003a00000000000000390c000000000000007a0000000000007b": "005e00000000000000390900000000000000000000000000007b",
  "004000000000000000390c000000000000007a0000000000007b": "005f00000000000000390b00000000000000000000000000007b",
  "003900000000000000390c000000000000007b0000000000007c": "005d00000000000000390400000000000000000000000000007c",
  "004000000000000000390c000000000000007b0000000000007c": "005e00000000000000390b00000000000000000000000000007c",
  "003a00000000000000390c000000000000007c0000000000007d": "005e00000000000000390900000000000000000000000000007d",
  "004000000000000000390c000000000000007c0000000000007d": "005f00000000000000390b00000000000000000000000000007d",
  "003900000000000000390c000000000000007d0000000000007e": "005c00000000000000390300000000000000000000000000007e",
  "004100000000000000390c000000000000007d0000000000007e": "005d00000000000000390b00000000000000000000000000007e",
  "003a00000000000000390c000000000000007e0000000000007f": "005e00000000000000390900000000000000000000000000007f",
  "004100000000000000390c000000000000007e0000000000007f": "005f00000000000000390b00000000000000000000000000007f"
}