{
  "003900000000000000390c0000000000000000000000000003e7": "0073000000000000003907000000000000000000000000000001",
  "004000000000000000390c0000000000000000000000000003e7": "007400000000000000390b000000000000000000000000000001",
  "003900000000000000390c0000000000000001000000000003e7": "0073000000000000003908000000000000000000000000000002",
  "004000000000000000390c0000000000000001000000000003e7": "007400000000000000390b000000000000000000000000000002",
  "003900000000000000390c0000000000000002000000000003e7": "0074000000000000003906000000000000000000000000000003",
  "004000000000000000390c0000000000000002000000000003e7": "007500000000000000390b000000000000000000000000000003",
  "003900000000000000390c0000000000000003000000000003e7": "0073000000000000003907000000000000000000000000000004",
  "004000000000000000390c0000000000000003000000000003e7": "007400000000000000390b000000000000000000000000000004",
  "003a00000000000000390c0000000000000004000000000003e7": "0073000000000000003907000000000000000000000000000005",
  "004000000000000000390c0000000000000004000000000003e7": "007400000000000000390b000000000000000000000000000005",
  "003a00000000000000390c0000000000000005000000000003e7": "0073000000000000003906000000000000000000000000000006",
  "004000000000000000390c0000000000000005000000000003e7": "007400000000000000390b000000000000000000000000000006",
  "003900000000000000390c0000000000000006000000000003e7": "0075000000000000003907000000000000000000000000000007",
  "004000000000000000390c0000000000000006000000000003e7": "007600000000000000390b000000000000000000000000000007",
  "003a00000000000000390c0000000000000007000000000003e7": "0074000000000000003907000000000000000000000000000008",
  "004000000000000000390c0000000000000007000000000003e7": "007500000000000000390b000000000000000000000000000008",
  "003900000000000000390c0000000000000008000000000003e7": "0073000000000000003907000000000000000000000000000009",
  "004000000000000000390c0000000000000008000000000003e7": "007400000000000000390b000000000000000000000000000009",
  "003a000000000000000a0c0000000000000009000000000003e7": "0073000000000000000a0800000000000000000000000000000a",
  "004000000000000000390c0000000000000009000000000003e7": "007400000000000000390b00000000000000000000000000000a",
  "003900000000000000390c000000000000000a000000000003e7": "007300000000000000390700000000000000000000000000000b",
  "004000000000000000390c000000000000000a000000000003e7": "007400000000000000390b00000000000000000000000000000b",
  "003a00000000000000390c000000000000000b000000000003e7": "007200000000000000390700000000000000000000000000000c",
  "004000000000000000390c000000000000000b000000000003e7": "007300000000000000390b00000000000000000000000000000c",
  "003a00000000000000390c000000000000000c000000000003e7": "007300000000000000390800000000000000000000000000000d",
  "004100000000000000390c000000000000000c000000000003e7": "007400000000000000390b00000000000000000000000000000d",
  "003900000000000000390c000000000000000d000000000003e7": "007400000000000000390600000000000000000000000000000e",
  "004000000000000000390c000000000000000d000000000003e7": "007500000000000000390b00000000000000000000000000000e",
  "003900000000000000390c000000000000000e000000000003e7": "007300000000000000390600000000000000000000000000000f",
  "004000000000000000390c000000000000000e000000000003e7": "007400000000000000390b00000000000000000000000000000f",
  "003a00000000000000390c000000000000000f000000000003e7": "0072000000000000003908000000000000000000000000000010",
  "004000000000000000390c000000000000000f000000000003e7": "007300000000000000390b000000000000000000000000000010",
  "003900000000000000390c0000000000000010000000000003e7": "0073000000000000003906000000000000000000000000000011",
  "004000000000000000390c0000000000000010000000000003e7": "007400000000000000390b000000000000000000000000000011",
  "003900000000000000390c0000000000000011000000000003e7": "0073000000000000003907000000000000000000000000000012",
  "003f00000000000000390c0000000000000011000000000003e7": "007400000000000000390b000000000000000000000000000012",
  "003900000000000000390c0000000000000012000000000003e7": "0073000000000000003904000000000000000000000000000013",
  "004000000000000000390c0000000000000012000000000003e7": "007400000000000000390b000000000000000000000000000013",
  "003900000000000000390c0000000000000013000000000003e7": "0071000000000000003908000000000000000000000000000014",
  "004000000000000000390c0000000000000013000000000003e7": "007200000000000000390b000000000000000000000000000014",
  "003900000000000000390c0000000000000014000000000003e7": "0072000000000000003907000000000000000000000000000015",
  "004000000000000000390c0000000000000014000000000003e7": "007300000000000000390b000000000000000000000000000015",
  "003900000000000000390c0000000000000015000000000003e7": "0072000000000000003907000000000000000000000000000016",
  "004000000000000000390c0000000000000015000000000003e7": "007300000000000000390b000000000000000000000000000016",
  "003a00000000000000390c0000000000000016000000000003e7": "0074000000000000003907000000000000000000000000000017",
  "004000000000000000390c0000000000000016000000000003e7": "007500000000000000390b000000000000000000000000000017",
  "003900000000000000390c0000000000000017000000000003e7": "0073000000000000003905000000000000000000000000000018",
  "004000000000000000390c0000000000000017000000000003e7": "007400000000000000390b000000000000000000000000000018",
  "003a00000000000000390c0000000000000018000000000003e7": "0073000000000000003907000000000000000000000000000019",
  "004000000000000000390c0000000000000018000000000003e7": "007400000000000000390b000000000000000000000000000019",
  "003900000000000000390c0000000000000019000000000003e7": "007200000000000000390600000000000000000000000000001a",
  "004000000000000000390c0000000000000019000000000003e7": "007300000000000000390b00000000000000000000000000001a",
  "003a00000000000000390c000000000000001a000000000003e7": "007300000000000000390600000000000000000000000000001b",
  "004000000000000000390c000000000000001a000000000003e7": "007400000000000000390b00000000000000000000000000001b",
  "003900000000000000390c000000000000001b000000000003e7": "007300000000000000390700000000000000000000000000001c",
  "004000000000000000390c000000000000001b000000000003e7": "007400000000000000390b00000000000000000000000000001c",
  "003a00000000000000390c000000000000001c000000000003e7": "007400000000000000390700000000000000000000000000001d",
  "004000000000000000390c000000000000001c000000000003e7": "007500000000000000390b00000000000000000000000000001d",
  "003a00000000000000390c000000000000001d000000000003e7": "007300000000000000390800000000000000000000000000001e",
  "004000000000000000390c000000000000001d000000000003e7": "007400000000000000390b00000000000000000000000000001e",
  "003a00000000000000390c000000000000001e000000000003e7": "007300000000000000390700000000000000000000000000001f",
  "004100000000000000390c000000000000001e000000000003e7": "007400000000000000390b00000000000000000000000000001f",
  "003a00000000000000390c000000000000001f000000000003e7": "0073000000000000003908000000000000000000000000000020",
  "004000000000000000390c000000000000001f000000000003e7": "007400000000000000390b000000000000000000000000000020",
  "003900000000000000390c0000000000000020000000000003e7": "0073000000000000003907000000000000000000000000000021",
  "004000000000000000390c0000000000000020000000000003e7": "007400000000000000390b000000000000000000000000000021",
  "003900000000000000390c0000000000000021000000000003e7": "0073000000000000003907000000000000000000000000000022",
  "004000000000000000390c0000000000000021000000000003e7": "007400000000000000390b000000000000000000000000000022",
  "003900000000000000390c0000000000000022000000000003e7": "0073000000000000003907000000000000000000000000000023",
  "004000000000000000390c0000000000000022000000000003e7": "007400000000000000390b000000000000000000000000000023",
  "003a00000000000000390c0000000000000023000000000003e7": "006f000000000000003907000000000000000000000000000024",
  "004000000000000000390c0000000000000023000000000003e7": "007000000000000000390b000000000000000000000000000024",
  "003900000000000000390c0000000000000024000000000003e7": "0070000000000000003907000000000000000000000000000025",
  "004000000000000000390c0000000000000024000000000003e7": "007100000000000000390b000000000000000000000000000025",
  "003900000000000000390c0000000000000025000000000003e7": "0070000000000000003907000000000000000000000000000026",
  "004000000000000000390c0000000000000025000000000003e7": "007100000000000000390b000000000000000000000000000026",
  "003900000000000000390c0000000000000026000000000003e7": "006f000000000000003907000000000000000000000000000027",
  "004000000000000000390c0000000000000026000000000003e7": "007000000000000000390b000000000000000000000000000027",
  "003900000000000000390c0000000000000027000000000003e7": "006f000000000000003907000000000000000000000000000028",
  "004000000000000000390c0000000000000027000000000003e7": "007000000000000000390b000000000000000000000000000028",
  "003a00000000000000390c0000000000000028000000000003e7": "006f000000000000003907000000000000000000000000000029",
  "004000000000000000390c0000000000000028000000000003e7": "007000000000000000390b000000000000000000000000000029",
  "003900000000000000390c0000000000000029000000000003e7": "006f00000000000000390600000000000000000000000000002a",
  "004000000000000000390c0000000000000029000000000003e7": "007000000000000000390b00000000000000000000000000002a",
  "003a00000000000000390c000000000000002a000000000003e7": "006d00000000000000390700000000000000000000000000002b",
  "004100000000000000390c000000000000002a000000000003e7": "006e00000000000000390b00000000000000000000000000002b",
  "003900000000000000390c000000000000002b000000000003e7": "006d00000000000000390700000000000000000000000000002c",
  "004100000000000000390c000000000000002b000000000003e7": "006e00000000000000390b00000000000000000000000000002c",
  "003900000000000000390c000000000000002c000000000003e7": "006d00000000000000390600000000000000000000000000002d",
  "004000000000000000390c000000000000002c000000000003e7": "006e00000000000000390b00000000000000000000000000002d",
  "003900000000000000390c000000000000002d000000000003e7": "006e00000000000000390700000000000000000000000000002e",
  "004000000000000000390c000000000000002d000000000003e7": "006f00000000000000390b00000000000000000000000000002e",
  "003a00000000000000390c000000000000002e000000000003e7": "006d00000000000000390700000000000000000000000000002f",
  "004000000000000000390c000000000000002e000000000003e7": "006e00000000000000390b00000000000000000000000000002f",
  "003900000000000000390c000000000000002f000000000003e7": "006d000000000000003906000000000000000000000000000030",
  "004000000000000000390c000000000000002f000000000003e7": "006e00000000000000390b000000000000000000000000000030",
  "003a00000000000000390c0000000000000030000000000003e7": "006d000000000000003906000000000000000000000000000031",
  "004100000000000000390c0000000000000030000000000003e7": "006e00000000000000390b000000000000000000000000000031",
  "003900000000000000390c0000000000000031000000000003e7": "006c000000000000003905000000000000000000000000000032",
  "004000000000000000390c0000000000000031000000000003e7": "006d00000000000000390b000000000000000000000000000032",
  "003900000000000000390c0000000000000032000000000003e7": "006d000000000000003907000000000000000000000000000033",
  "004000000000000000390c0000000000000032000000000003e7": "006e00000000000000390b000000000000000000000000000033",
  "003a00000000000000390c0000000000000033000000000003e7": "006c000000000000003908000000000000000000000000000034",
  "004000000000000000390c0000000000000033000000000003e7": "006d00000000000000390b000000000000000000000000000034",
  "003a00000000000000390c0000000000000034000000000003e7": "006c00000000000000390b000000000000000000000000000035",
  "004000000000000000390c0000000000000034000000000003e7": "006d000000000000003909000000000000000000000000000035",
  "003900000000000000390c0000000000000035000000000003e7": "006b000000000000003907000000000000000000000000000036",
  "004000000000000000390c0000000000000035000000000003e7": "006c00000000000000390b000000000000000000000000000036",
  "003900000000000000390c0000000000000036000000000003e7": "006a000000000000003908000000000000000000000000000037",
  "003f00000000000000390c0000000000000036000000000003e7": "006b00000000000000390b000000000000000000000000000037",
  "003900000000000000390c0000000000000037000000000003e7": "006b000000000000003904000000000000000000000000000038",
  "004000000000000000390c0000000000000037000000000003e7": "006c00000000000000390b000000000000000000000000000038",
  "003900000000000000390c0000000000000038000000000003e7": "006b000000000000003906000000000000000000000000000039",
  "004000000000000000390c0000000000000038000000000003e7": "006c00000000000000390b000000000000000000000000000039",
  "003900000000000000390c0000000000000039000000000003e7": "006900000000000000390700000000000000000000000000003a",
  "004000000000000000390c0000000000000039000000000003e7": "006a00000000000000390b00000000000000000000000000003a",
  "003a00000000000000390c000000000000003a000000000003e7": "006a00000000000000390700000000000000000000000000003b",
  "004000000000000000390c000000000000003a000000000003e7": "006b00000000000000390b00000000000000000000000000003b",
  "003a00000000000000390c000000000000003b000000000003e7": "006a00000000000000390800000000000000000000000000003c",
  "004100000000000000390c000000000000003b000000000003e7": "006b00000000000000390b00000000000000000000000000003c",
  "003900000000000000390c000000000000003c000000000003e7": "006900000000000000390700000000000000000000000000003d",
  "004000000000000000390c000000000000003c000000000003e7": "006a00000000000000390b00000000000000000000000000003d",
  "003a00000000000000390c000000000000003d000000000003e7": "006a00000000000000390800000000000000000000000000003e",
  "004000000000000000390c000000000000003d000000000003e7": "006b00000000000000390b00000000000000000000000000003e",
  "003900000000000000390c000000000000003e000000000003e7": "006a00000000000000390600000000000000000000000000003f",
  "004000000000000000390c000000000000003e000000000003e7": "006b00000000000000390b00000000000000000000000000003f",
  "003900000000000000390c000000000000003f000000000003e7": "006a000000000000003906000000000000000000000000000040",
  "004000000000000000390c000000000000003f000000000003e7": "006b00000000000000390b000000000000000000000000000040",
  "003900000000000000390c0000000000000040000000000003e7": "0069000000000000003907000000000000000000000000000041",
  "004000000000000000390c0000000000000040000000000003e7": "006a00000000000000390b000000000000000000000000000041",
  "003a00000000000000390c0000000000000041000000000003e7": "0069000000000000003907000000000000000000000000000042",
  "004100000000000000390c0000000000000041000000000003e7": "006a00000000000000390b000000000000000000000000000042",
  "003900000000000000390c0000000000000042000000000003e7": "0069000000000000003907000000000000000000000000000043",
  "004000000000000000390c0000000000000042000000000003e7": "006a00000000000000390b000000000000000000000000000043",
  "003900000000000000390c0000000000000043000000000003e7": "0069000000000000003906000000000000000000000000000044",
  "004100000000000000390c0000000000000043000000000003e7": "006a00000000000000390b000000000000000000000000000044",
  "003900000000000000390c0000000000000044000000000003e7": "0069000000000000003906000000000000000000000000000045",
  "004000000000000000390c0000000000000044000000000003e7": "006a00000000000000390b000000000000000000000000000045",
  "003900000000000000390c0000000000000045000000000003e7": "0068000000000000003907000000000000000000000000000046",
  "004000000000000000390c0000000000000045000000000003e7": "006900000000000000390b000000000000000000000000000046",
  "003900000000000000390c0000000000000046000000000003e7": "0069000000000000003906000000000000000000000000000047",
  "004000000000000000390c0000000000000046000000000003e7": "006a00000000000000390b000000000000000000000000000047",
  "003900000000000000390c0000000000000047000000000003e7": "0068000000000000003906000000000000000000000000000048",
  "004000000000000000390c0000000000000047000000000003e7": "006900000000000000390b000000000000000000000000000048",
  "003a00000000000000390c0000000000000048000000000003e7": "0068000000000000003907000000000000000000000000000049",
  "004000000000000000390c0000000000000048000000000003e7": "006900000000000000390b000000000000000000000000000049",
  "003900000000000000390c0000000000000049000000000003e7": "006800000000000000390800000000000000000000000000004a",
  "004000000000000000390c0000000000000049000000000003e7": "006900000000000000390b00000000000000000000000000004a",
  "003900000000000000390c000000000000004a000000000003e7": "006800000000000000390700000000000000000000000000004b",
  "004000000000000000390c000000000000004a000000000003e7": "006900000000000000390b00000000000000000000000000004b",
  "003900000000000000390c000000000000004b000000000003e7": "006800000000000000390800000000000000000000000000004c",
  "004000000000000000390c000000000000004b000000000003e7": "006900000000000000390b00000000000000000000000000004c",
  "003900000000000000390c000000000000004c000000000003e7": "006700000000000000390500000000000000000000000000004d",
  "004000000000000000390c000000000000004c000000000003e7": "006800000000000000390b00000000000000000000000000004d",
  "003a00000000000000390c000000000000004d000000000003e7": "006600000000000000390700000000000000000000000000004e",
  "004000000000000000390c000000000000004d000000000003e7": "006700000000000000390b00000000000000000000000000004e",
  "003a00000000000000390c000000000000004e000000000003e7": "006600000000000000390700000000000000000000000000004f",
  "004000000000000000390c000000000000004e000000000003e7": "006700000000000000390b00000000000000000000000000004f",
  "003a00000000000000390c000000000000004f000000000003e7": "0066000000000000003907000000000000000000000000000050",
  "004000000000000000390c000000000000004f000000000003e7": "006700000000000000390b000000000000000000000000000050",
  "003900000000000000390c0000000000000050000000000003e7": "0066000000000000003906000000000000000000000000000051",
  "004000000000000000390c0000000000000050000000000003e7": "006700000000000000390b000000000000000000000000000051",
  "003a000000000000000a0c0000000000000051000000000003e7": "0066000000000000000a08000000000000000000000000000052",
  "004000000000000000390c0000000000000051000000000003e7": "006700000000000000390b000000000000000000000000000052",
  "003a00000000000000390c0000000000000052000000000003e7": "0065000000000000003907000000000000000000000000000053",
  "004000000000000000390c0000000000000052000000000003e7": "006600000000000000390b000000000000000000000000000053",
  "003a00000000000000390c0000000000000053000000000003e7": "006500000000000000390b000000000000000000000000000054",
  "003f00000000000000390c0000000000000053000000000003e7": "0066000000000000003909000000000000000000000000000054",
  "003900000000000000390c0000000000000054000000000003e7": "0064000000000000003905000000000000000000000000000055",
  "004100000000000000390c0000000000000054000000000003e7": "006500000000000000390b000000000000000000000000000055",
  "003b00000000000000390c0000000000000055000000000003e7": "006500000000000000390b000000000000000000000000000056",
  "004000000000000000390c0000000000000055000000000003e7": "0066000000000000003909000000000000000000000000000056",
  "003900000000000000390c0000000000000056000000000003e7": "0064000000000000003903000000000000000000000000000057",
  "004100000000000000390c0000000000000056000000000003e7": "006500000000000000390b000000000000000000000000000057",
  "003900000000000000390c0000000000000057000000000003e7": "0064000000000000003906000000000000000000000000000058",
  "004000000000000000390c0000000000000057000000000003e7": "006500000000000000390b000000000000000000000000000058",
  "003900000000000000390c0000000000000058000000000003e7": "0064000000000000003906000000000000000000000000000059",
  "004100000000000000390c0000000000000058000000000003e7": "006500000000000000390b000000000000000000000000000059",
  "003900000000000000390c0000000000000059000000000003e7": "006300000000000000390400000000000000000000000000005a",
  "004000000000000000390c0000000000000059000000000003e7": "006400000000000000390b00000000000000000000000000005a",
  "003900000000000000390c000000000000005a000000000003e7": "006400000000000000390300000000000000000000000000005b",
  "004000000000000000390c000000000000005a000000000003e7": "006500000000000000390b00000000000000000000000000005b",
  "003900000000000000390c000000000000005b000000000003e7": "006400000000000000390400000000000000000000000000005c",
  "003f00000000000000390c000000000000005b000000000003e7": "006500000000000000390b00000000000000000000000000005c",
  "003900000000000000390c000000000000005c000000000003e7": "006300000000000000390400000000000000000000000000005d",
  "004000000000000000390c000000000000005c000000000003e7": "006400000000000000390b00000000000000000000000000005d",
  "003900000000000000390c000000000000005d000000000003e7": "006300000000000000390400000000000000000000000000005e",
  "003f00000000000000390c000000000000005d000000000003e7": "006400000000000000390b00000000000000000000000000005e",
  "003900000000000000390c000000000000005e000000000003e7": "006300000000000000390300000000000000000000000000005f",
  "004100000000000000390c000000000000005e000000000003e7": "006400000000000000390b00000000000000000000000000005f",
  "003a00000000000000390c000000000000005f000000000003e7": "006300000000000000390b000000000000000000000000000060",
  "003f00000000000000390c000000000000005f000000000003e7": "0064000000000000003909000000000000000000000000000060",
  "003a00000000000000390c0000000000000060000000000003e7": "006300000000000000390b000000000000000000000000000061",
  "003f00000000000000390c0000000000000060000000000003e7": "0064000000000000003909000000000000000000000000000061",
  "003900000000000000390c0000000000000061000000000003e7": "0062000000000000003903000000000000000000000000000062",
  "004000000000000000390c0000000000000061000000000003e7": "006300000000000000390b000000000000000000000000000062",
  "003a00000000000000390c0000000000000062000000000003e7": "006300000000000000390b000000000000000000000000000063",
  "003f00000000000000390c0000000000000062000000000003e7": "0064000000000000003908000000000000000000000000000063",
  "003900000000000000390c0000000000000063000000000003e7": "0062000000000000003903000000000000000000000000000064",
  "004000000000000000390c0000000000000063000000000003e7": "006300000000000000390b000000000000000000000000000064",
  "003a00000000000000390c0000000000000064000000000003e7": "006300000000000000390b000000000000000000000000000065",
  "004000000000000000390c0000000000000064000000000003e7": "006400000000000000390a000000000000000000000000000065",
  "003900000000000000390c0000000000000065000000000003e7": "0061000000000000003903000000000000000000000000000066",
  "004000000000000000390c0000000000000065000000000003e7": "006200000000000000390b000000000000000000000000000066",
  "003900000000000000390c0000000000000066000000000003e7": "0061000000000000003903000000000000000000000000000067",
  "004000000000000000390c0000000000000066000000000003e7": "006200000000000000390b000000000000000000000000000067",
  "003900000000000000390c0000000000000067000000000003e7": "0060000000000000003905000000000000000000000000000068",
  "004000000000000000390c0000000000000067000000000003e7": "006100000000000000390b000000000000000000000000000068",
  "003900000000000000390c0000000000000068000000000003e7": "0060000000000000003904000000000000000000000000000069",
  "004000000000000000390c0000000000000068000000000003e7": "006100000000000000390b000000000000000000000000000069",
  "003900000000000000390c0000000000000069000000000003e7": "006000000000000000390500000000000000000000000000006a",
  "004000000000000000390c0000000000000069000000000003e7": "006100000000000000390b00000000000000000000000000006a",
  "003900000000000000390c000000000000006a000000000003e7": "006100000000000000390300000000000000000000000000006b",
  "004000000000000000390c000000000000006a000000000003e7": "006200000000000000390b00000000000000000000000000006b",
  "003900000000000000390c000000000000006b000000000003e7": "006000000000000000390500000000000000000000000000006c",
  "004000000000000000390c000000000000006b000000000003e7": "006100000000000000390b00000000000000000000000000006c",
  "003900000000000000390c000000000000006c000000000003e7": "006000000000000000390500000000000000000000000000006d",
  "004000000000000000390c000000000000006c000000000003e7": "006100000000000000390b00000000000000000000000000006d",
  "003900000000000000390c000000000000006d000000000003e7": "005f00000000000000390400000000000000000000000000006e",
  "004000000000000000390c000000000000006d000000000003e7": "006000000000000000390b00000000000000000000000000006e",
  "0039000000000000000a0c000000000000006e000000000003e7": "005f000000000000000a0600000000000000000000000000006f",
  "003f00000000000000390c000000000000006e000000000003e7": "006000000000000000390b00000000000000000000000000006f",
  "003900000000000000390c000000000000006f000000000003e7": "005d000000000000003905000000000000000000000000000070",
  "004000000000000000390c000000000000006f000000000003e7": "005e00000000000000390b000000000000000000000000000070",
  "003900000000000000390c0000000000000070000000000003e7": "005f000000000000003904000000000000000000000000000071",
  "004000000000000000390c0000000000000070000000000003e7": "006000000000000000390b000000000000000000000000000071",
  "003900000000000000390c0000000000000071000000000003e7": "005d000000000000003905000000000000000000000000000072",
  "004000000000000000390c0000000000000071000000000003e7": "005e00000000000000390b000000000000000000000000000072",
  "000000000000000000070c0000000000000072000000000003e7": "005e000000000000000700000000000000000000000000000073",
  "003c00000000000000390c0000000000000072000000000003e7": "005f00000000000000390b000000000000000000000000000073",
  "003a00000000000000390c0000000000000073000000000003e7": "005e00000000000000390b000000000000000000000000000074",
  "004000000000000000390c0000000000000073000000000003e7": "005f00000000000000390a000000000000000000000000000074",
  "003900000000000000390c0000000000000074000000000003e7": "005f000000000000003909000000000000000000000000000075",
  "004000000000000000390c0000000000000074000000000003e7": "006000000000000000390b000000000000000000000000000075",
  "003900000000000000390c0000000000000075000000000003e7": "005d000000000000003906000000000000000000000000000076",
  "004000000000000000390c0000000000000075000000000003e7": "005e00000000000000390b000000000000000000000000000076",
  "003a00000000000000390c0000000000000076000000000003e7": "005f000000000000003909000000000000000000000000000077",
  "004000000000000000390c0000000000000076000000000003e7": "006000000000000000390b000000000000000000000000000077",
  "003a00000000000000390c0000000000000077000000000003e7": "005e00000000000000390b000000000000000000000000000078",
  "004000000000000000390c0000000000000077000000000003e7": "005f00000000000000390a000000000000000000000000000078",
  "003a00000000000000390c0000000000000078000000000003e7": "005f000000000000003909000000000000000000000000000079",
  "004100000000000000390c0000000000000078000000000003e7": "006000000000000000390b000000000000000000000000000079",
  "003a00000000000000390c0000000000000079000000000003e7": "005e00000000000000390b00000000000000000000000000007a",
  "004000000000000000390c0000000000000079000000000003e7": "005f00000000000000390a00000000000000000000000000007a",
  "003a00000000000000390c000000000000007a000000000003e7": "005e00000000000000390900000000000000000000000000007b",
  "004000000000000000390c000000000000007a000000000003e7": "005f00000000000000390b00000000000000000000000000007b",
  "003900000000000000390c000000000000007b000000000003e7": "005d00000000000000390400000000000000000000000000007c",
  "004000000000000000390c000000000000007b000000000003e7": "005e00000000000000390b00000000000000000000000000007c",
  "003a00000000000000390c000000000000007c000000000003e7": "005e00000000000000390900000000000000000000000000007d",
  "004000000000000000390c000000000000007c000000000003e7": "005f00000000000000390b00000000000000000000000000007d",
  "003900000000000000390c000000000000007d000000000003e7": "005c00000000000000390300000000000000000000000000007e",
  "004100000000000000390c000000000000007d000000000003e7": "005d00000000000000390b00000000000000000000000000007e",
  "003a00000000000000390c000000000000007e000000000003e7": "005e00000000000000390900000000000000000000000000007f",
  "004100000000000000390c000000000000007e000000000003e7": "005f00000000000000390b00000000000000000000000000007f"
}